I	მე
Do	კეთება
Go	წადი
He	ის
Me	მე
My	ჩემი
No	არა
On	ზე
Or	ან
So	ისე
Up	ზევით
We	ჩვენ
Act	იმოქმედოს
Add	დაამატეთ
Age	ასაკი
Aim	მიზანი
Air	საჰაერო
All	ყველა
And	და
Ant	ჭიანჭველა
Any	ნებისმიერი
Ask	იკითხე
Bad	ცუდი
Big	დიდი
Buy	ყიდვა
Cry	ტირილი
Dam	კაშხალი
Die	მოკვდეს
Dry	მშრალი
End	დასასრული
Ear	ყური
Eat	ჭამე
Egg	კვერცხი
Eye	თვალი
Fat	მსუქანი
Fly	ფრენა
Fun	გართობა
Get	მიიღეთ
God	ღმერთო
Hen	ქათამი
Hot	ცხელი
Job	სამუშაო
Leg	ფეხი
Lie	ტყუილი
Low	დაბალი
Mad	შეშლილი
Man	კაცი
Not	არა
Now	ახლა
New	ახალი
Old	ძველი
Own	საკუთარი
Run	გაშვება
Sad	სევდიანი
Sea	ზღვის
See	იხილეთ
Shy	მორცხვი
Sit	დაჯექი
Sum	ჯამი
Sun	მზე
Tax	გადასახადი
Try	სცადე
Use	გამოყენება
War	ომი
Wet	სველი
Why	რატომ
Win	გამარჯვება
Yes	დიახ
You	შენ
Also	ასევე
Baby	ბავშვი
Back	უკან
Bake	გამოცხობა
Bald	მელოტი
Ball	ბურთი
Bark	ქერქი
Bath	აბანო
Beet	ჭარხალი
Bend	წარმართონ
Best	საუკეთესო
Bird	ჩიტი
Bold	გაბედული
Bone	ძვალი
Book	წიგნი
Born	დაბადებული
Both	ორივე
Busy	დაკავებული
Call	ზარი
Calm	მშვიდი
Care	ზრუნვა
Come	მოდი
Cost	ღირებულება
Cute	საყვარელი
Crow	ყვავი
Dare	გაბედე
Dark	ბნელი
Date	თარიღი
Deal	გარიგება
Diet	დიეტა
Dish	კერძი
Door	კარი
Down	ქვემოთ
Dust	მტვერი
Each	თითოეული
Earn	შოვნა
Easy	ადვილი
Edge	ზღვარი
Evil	ბოროტი
Exit	გასასვლელი
Face	სახე
Fact	ფაქტი
Fair	სამართლიანი
Fake	ყალბი
Farm	ფერმა
Fast	სწრაფი
Fear	შიში
Feel	გრძნობენ
Find	იპოვე
Fine	ჯარიმა
Fish	თევზი
Food	საკვები
Fool	სულელი
Free	უფასო
Frog	ბაყაყი
Full	სავსე
Gape	ღიმილი
Gift	საჩუქარი
Girl	გოგო
Goat	თხა
Good	კარგი
Grab	ხელში ჩაგდება
Grow	იზრდება
Half	ნახევარი
Hate	სიძულვილი
Head	ხელმძღვანელი
Hear	მოისმინე
Heat	სითბო
Help	დახმარება
Here	აქ
Hide	დამალვა
High	მაღალი
Hold	გამართავს
Hole	ხვრელი
Home	სახლში
Huge	უზარმაზარი
Hurt	დააზარალებს
Idea	იდეა
Jump	ხტომა
Just	უბრალოდ
Kill	მოკვლა
Land	მიწა
Last	ბოლო
Late	გვიან
Left	დატოვა
Life	ცხოვრება
Line	ხაზი
Lion	ლომი
Long	გრძელი
Look	შეხედე
Lost	დაკარგული
Love	სიყვარული
Luck	იღბალი
Lung	ფილტვის
Many	ბევრი
Meet	შეხვედრა
Melt	დნება
Milk	რძე
Must	უნდა
Name	სახელი
Near	ახლოს
Neat	სისუფთავე
Neck	კისერი
Need	საჭიროება
Next	შემდეგი
Only	მხოლოდ
Pain	ტკივილი
Pair	წყვილი
Park	პარკი
Path	გზა
Play	თამაში
Poor	ღარიბი
Pull	გაიყვანეთ
Pure	წმინდა
Quit	დატოვა
Quiz	ვიქტორინა
Race	რასის
Rain	წვიმა
Rare	იშვიათი
Real	რეალური
Rent	ქირავდება
Rest	დასვენება
Rich	მდიდარი
Ride	გასეირნება
Rise	აწევა
Risk	რისკი
Room	ოთახი
Rope	თოკი
Rude	უხეში
Sage	ბრძენი
Sail	აფრების
Salt	მარილი
Same	იგივე
Sand	ქვიშა
Save	გადარჩენა
Scam	თაღლითობა
Seed	თესლი
Seek	ეძიოს
Self	თვით
Sell	გაყიდე
Send	გაგზავნა
Shop	მაღაზია
Show	შოუ
Sick	ავადმყოფი
Side	მხარე
Site	საიტი
Size	ზომა
Skin	კანი
Slow	ნელი
Soft	რბილი
Soil	ნიადაგი
Some	ზოგიერთი
Soon	მალე
Stay	დარჩენა
Stop	გაჩერება
Such	ასეთი
Swap	გაცვლა
Swim	ცურვა
Take	მიიღოს
Talk	საუბარი
Tall	მაღალი
Team	გუნდი
Tell	უთხარი
Tent	კარავი
That	რომ
Then	მაშინ
Thin	გამხდარი
This	ეს
Tide	ტალღა
Time	დრო
Tour	ტური
Town	ქალაქი
Tree	ხე
Trip	მოგზაურობა
Turn	მობრუნება
Ugly	მახინჯი
Vase	ვაზა
Vein	ვენა
Very	ძალიან
View	ხედი
Wage	ხელფასი
Wait	დაელოდე
Wake	გაღვიძება
Walk	ფეხით
Wall	კედელი
Want	მინდა
Warm	თბილი
Warn	გაფრთხილება
Weak	სუსტი
Wear	აცვიათ
Week	კვირა
Well	კარგად
Went	წავიდა
What	რა
When	როდესაც
Wide	ფართო
Wife	ცოლი
Wild	ველური
Will	ნება
Wind	ქარი
Wine	ღვინო
Wish	სურვილი
Wood	ტყე
Wool	მატყლი
Word	სიტყვა
Work	მუშაობა
Worm	ჭია
Yarn	ნართი
Your	შენი
Zoom	მასშტაბირება
Above	ზემოთ
Adapt	ადაპტირება
Admit	აღიარე
Adult	ზრდასრული
After	შემდეგ
Again	ისევ
Agree	ვეთანხმები
Alert	გაფრთხილება
Allow	დაუშვას
Alone	მარტო
Along	გასწვრივ
Anger	გაბრაზება
Angle	კუთხე
Angry	გაბრაზებული
Asset	აქტივი
Avoid	აცილება
Awake	გაღვიძებული
Aware	იცის
Begin	დაიწყოს
Birth	დაბადების
Blood	სისხლი
Brain	ტვინი
Built	აშენებული
Bring	მოიტანეთ
Build	აშენება
Camel	აქლემი
Canal	არხი
Carry	ტარება
Cheap	იაფი
Cheat	მოტყუებას
Check	ჩეკი
Chest	მკერდი
Claim	მოთხოვნა
Clean	სუფთა
Clear	ნათელი
Climb	ასვლა
Close	დახურვა
Cloth	ქსოვილი
Cloud	ღრუბელი
Color	ფერი
Crime	დანაშაული
Crowd	ბრბო
Crown	გვირგვინი
Daily	ყოველდღიურად
Dance	ცეკვა
Death	სიკვდილი
Decay	გაფუჭება
Delay	დაგვიანებით
Devil	ეშმაკი
Dirty	ბინძური
Dress	კაბა
Drink	სასმელი
Drive	მართოს
Dwell	დასახლება
Eager	მონდომებული
Eagle	არწივი
Early	ადრე
Earth	დედამიწა
Elder	უფროსი
Empty	ცარიელი
Enemy	მტერი
Enjoy	ისიამოვნეთ
Entry	შესვლა
Equal	თანაბარი
Essay	ესე
Event	ღონისძიება
Every	ყოველი
Exact	ზუსტი
Exist	არსებობს
Extra	ზედმეტი
Faith	რწმენა
Fault	ბრალია
Fever	ცხელება
Field	ველი
Final	საბოლოო
Fleet	ფლოტი
Float	ათწილადი
Flood	წყალდიდობა
Floor	იატაკი
Flour	ფქვილი
Fluid	სითხე
Focus	ფოკუსირება
Force	ძალა
Fraud	თაღლითობა
Fresh	ახალი
Front	წინა
Fruit	ხილი
Ghost	მოჩვენება
Globe	გლობუსი
Going	მიდის
Grain	მარცვლეული
Grant	გრანტი
Grass	ბალახი
Great	დიდი
Group	ჯგუფი
Guard	მცველი
Guest	სტუმარი
Habit	ჩვევა
Heart	გული
Honey	თაფლი
Horse	ცხენი
House	სახლი
Human	ადამიანის
Ideal	იდეალური
Issue	პრობლემა
Judge	მოსამართლე
Knife	დანა
Labor	შრომა
Ladle	კალთა
Large	დიდი
Laugh	სიცილი
Learn	ვისწავლოთ
Leave	დატოვება
Legal	ლეგალური
Limit	ზღვარი
Lunch	სადილი
Metal	ლითონის
Mixed	შერეული
Money	ფული
Month	თვე
Mount	მთაზე
Mouth	პირი
Music	მუსიკა
Maize	სიმინდი
Naked	შიშველი
Never	არასოდეს
Night	ღამე
Niece	დისშვილი
Noise	ხმაური
Occur	მოხდეს
Ocean	ოკეანის
Onion	ხახვი
Offer	შეთავაზება
Order	შეკვეთა
Organ	ორგანო
Other	სხვა
Owner	მფლობელი
Paddy	პედი
Panic	პანიკა
Peace	მშვიდობა
Place	ადგილი
Plant	მცენარე
Price	ფასი
Pride	სიამაყე
Proud	ამაყი
Prove	დაამტკიცოს
Quilt	ქვილთი
Quick	სწრაფი
Quite	საკმაოდ
Raise	ამაღლება
Reach	მიღწევა
React	რეაგირება
Ready	მზადაა
Reply	პასუხი
Right	უფლება
Round	მრგვალი
Rural	სოფლის
Saint	წმინდანი
Scope	ფარგლები
Score	ქულა
Sense	გრძნობა
Shake	შერყევა
Shape	ფორმა
Share	გაზიარება
Sharp	ბასრი
Shrub	ბუჩქი
Skill	უნარი
Sleep	ძილი
Slope	ფერდობზე
Small	პატარა
Smell	სუნი
Smile	ღიმილი
Snake	გველი
Snore	ხვრინვა
Solid	მყარი
Sound	ხმა
Space	სივრცე
Speak	საუბარი
Speed	სიჩქარე
Spend	დახარჯვა
Spent	გაატარა
Sperm	სპერმა
Sport	სპორტი
Stand	დგომა
Steam	ორთქლი
Stone	ქვა
Story	ამბავი
Taste	გემო
Teach	ასწავლე
Teeth	კბილები
Thank	მადლობა
There	იქ
These	ეს
Thick	სქელი
Thing	ნივთი
Tiger	ვეფხვი
Today	დღეს
Total	სულ
Treat	მკურნალობა
Trend	ტენდენცია
Tried	ცდილობდა
Trust	ნდობა
Truth	სიმართლე
Twice	ორჯერ
Under	ქვეშ
Upper	ზედა
Urban	ქალაქური
Visit	ვიზიტი
Voice	ხმა
Vomit	ღებინება
Waste	დახარჯვა
Water	წყალი
Wheat	ხორბალი
Where	სადაც
White	თეთრი
Whole	მთლიანი
Woman	ქალი
World	მსოფლიო
Worst	ყველაზე ცუდი
Write	დაწერე
Wrong	არასწორი
Yield	მოსავლიანობა
Young	ახალგაზრდა
Youth	ახალგაზრდობა
Absent	არდამსწრე
Accept	მიღება
Admire	აღფრთოვანებული ვარ
Advice	რჩევა
Almost	თითქმის
Always	ყოველთვის
Animal	ცხოველი
Answer	პასუხი
Appeal	მიმართვა
Appear	გამოჩნდება
Arrive	ჩამოსვლა
Artist	მხატვარი
Assist	დახმარება
Attack	თავდასხმა
Attach	მიამაგრეთ
Attend	დასწრება
Bangle	სამაჯური
Before	ადრე
Behind	უკან
Bellow	ქვემოთ
Better	უკეთესი
Borrow	სესხება
Bottom	ქვედა
Broken	გატეხილი
Budget	ბიუჯეტი
Cancel	გააუქმოს
Cancer	კიბო
Carrot	სტაფილო
Cattle	მსხვილფეხა რქოსანი პირუტყვი
Common	საერთო
Compel	აიძულოს
Corner	კუთხე
Couple	წყვილი
Course	კურსი
Create	შექმნა
Custom	საბაჟო
Damage	დაზიანება
Dancer	მოცეკვავე
Danger	საფრთხე
Decade	ათწლეული
Defeat	დამარცხება
Delete	წაშლა
Demand	მოთხოვნა
Desire	სურვილი
Detail	დეტალი
Dinner	ვახშამი
Divine	ღვთაებრივი
Donkey	ვირი
Double	ორმაგი
Edible	საკვები
Effect	ეფექტი
Either	ან
Empire	იმპერია
Energy	ენერგია
Enough	საკმარისი
Ensure	უზრუნველყოს
Entire	მთელი
Except	გარდა
Expand	გაფართოება
Expect	ველით
Export	ექსპორტი
Extend	გაფართოება
Facade	ფასადი
Family	ოჯახი
Famous	ცნობილი
Faulty	გაუმართავი
Favour	კეთილგანწყობა
Female	ქალი
Fiance	საქმრო
Finish	დასრულება
Flower	ყვავილი
Forest	ტყე
Forgot	დაავიწყდა
Freeze	გაყინვას
Friend	მეგობარი
Future	მომავალი
Garage	ავტოფარეხი
Garden	ბაღი
Garlic	ნიორი
Ginger	ჯანჯაფილი
Global	გლობალური
Ground	ადგილზე
Growth	ზრდა
Health	ჯანმრთელობა
Hidden	დამალული
Honest	პატიოსანი
Honour	პატივი
Hostel	ჰოსტელი
Humble	თავმდაბალი
Hungry	მშიერი
Ignore	იგნორირება
Impact	გავლენა
Impure	უწმინდური
Income	შემოსავალი
Inform	ინფორმირება
Insect	მწერის
Inside	შიგნით
Jungle	ჯუნგლები
Kidnap	გატაცება
Kindle	აანთებს
Labour	შრომა
Leader	ლიდერი
Length	სიგრძე
Letter	წერილი
Liquid	თხევადი
Little	პატარა
Living	ცხოვრება
Lizard	ხვლიკი
Locate	განთავსება
Luxury	ფუფუნება
Making	მიღების
Mammal	ძუძუმწოვარი
Manage	მართვა
Manual	სახელმძღვანელო
Market	ბაზარი
Mental	გონებრივი
Method	მეთოდი
Middle	შუა
Monkey	მაიმუნი
Mother	დედა
Muscle	კუნთი
Narrow	ვიწრო
Native	მშობლიური
Nature	ბუნება
Normal	ნორმალური
Number	ნომერი
Object	ობიექტი
Office	ოფისი
Option	ვარიანტი
Parent	მშობელი
Parrot	თუთიყუში
People	ხალხი
Person	პირი
Pickle	მწნილი
Picnic	პიკნიკი
Pigeon	მტრედი
Planet	პლანეტა
Please	გთხოვთ
Plenty	უამრავი
Police	პოლიცია
Potato	კარტოფილი
Praise	დიდება
Prayer	ლოცვა
Pretty	ლამაზი
Prince	პრინცი
Profit	მოგება
Proper	სათანადო
Public	საჯარო
Rabbit	კურდღელი
Recent	ბოლო
Recipe	რეცეპტი
Record	ჩანაწერი
Reduce	შემცირება
Regret	სინანული
Reject	უარი თქვას
Remind	შეხსენება
Remove	ამოღება
Repair	შეკეთება
Repeat	გაიმეორეთ
Return	დაბრუნების
Rotate	როტაცია
Safety	უსაფრთხოება
Salary	ხელფასი
Sample	ნიმუში
School	სკოლა
Screen	ეკრანი
Script	სკრიპტი
Scroll	გადახვევა
Search	ძებნა
Season	სეზონი
Secret	საიდუმლო
Secure	უსაფრთხო
Select	აირჩიეთ
Senior	უფროსი
Shield	იცავს
Should	უნდა
Shower	შხაპი
Silent	ჩუმად
Single	მარტოხელა
Sister	დას
Smooth	გლუვი
Social	სოციალური
Speech	მეტყველება
Street	ქუჩა
Strong	ძლიერი
Sudden	მოულოდნელი
Summer	ზაფხულის
Supply	მიწოდება
Talent	ნიჭი
Temple	ტაძარი
Thread	ძაფი
Thrill	მღელვარება
Throat	ყელი
Tittle	ტიტული
Toilet	ტუალეტი
Tomato	პომიდორი
Tongue	ენა
Travel	მოგზაურობა
Tunnel	გვირაბი
Turtle	კუს
Unseen	უხილავი
Update	განახლება
Urgent	სასწრაფო
Useful	სასარგებლო
Vacate	გაათავისუფლე
Vacuum	ვაკუუმი
Vapour	ორთქლი
Verify	გადაამოწმეთ
Virgin	ქალწული
Wealth	სიმდიდრე
Weekly	ყოველკვირეული
Weight	წონა
Winter	ზამთარი
Winner	გამარჯვებული
Wonder	საოცრება
Worker	მუშაკი
Writer	მწერალი
Yearly	ყოველწლიურად
Achieve	მიღწევა
Advance	წინსვლა
Against	წინააღმდეგ
Already	უკვე
Ancient	უძველესი
Anybody	ვინმეს
Approve	დაამტკიცოს
Apology	ბოდიში
Archive	არქივი
Arrange	მოწყობა
Arrival	ჩამოსვლა
Article	სტატია
Attempt	მცდელობა
Attract	მოზიდვა
Average	საშუალოდ
Bandage	ბინტი
Barrage	ბარაჟი
Barrier	ბარიერი
Because	რადგან
Benefit	სარგებელი
Between	შორის
Cabbage	კომბოსტო
Capture	ხელში ჩაგდება
Careful	ფრთხილად
Carrier	გადამზიდავი
Century	საუკუნეში
Certain	გარკვეული
Chamber	პალატა
Chapter	თავი
Charity	ქველმოქმედება
Climate	კლიმატი
Coconut	ქოქოსი
Collect	შეგროვება
College	კოლეჯი
Comfort	კომფორტს
Command	ბრძანება
Comment	კომენტარი
Company	კომპანია
Compare	შეადარეთ
Concept	შინაარსი
Concern	შეშფოთება
Conduct	ქცევა
Confirm	დაადასტურეთ
Connect	დაკავშირება
Contact	კონტაქტი
Control	კონტროლი
Convert	გარდაქმნის
Correct	სწორი
Costume	კოსტუმი
Cottage	კოტეჯი
Country	ქვეყანა
Courage	გამბედაობა
Cucumber	კიტრი
Curious	ცნობისმოყვარე
Declare	აცხადებენ
Defense	დაცვა
Dentist	სტომატოლოგი
Deposit	ანაბარი
Despite	მიუხედავად იმისა
Destiny	ბედისწერა
Destroy	განადგურება
Develop	განავითაროს
Disease	დაავადება
Display	ჩვენება
Disturb	აწუხებს
Dynasty	დინასტია
Eagerly	მოუთმენლად
Earning	გამომუშავება
Eatable	ჭამადი
Ecology	ეკოლოგია
Economy	ეკონომია
Edition	გამოცემა
Elegant	ელეგანტური
Enhance	გააძლიეროს
Episode	ეპიზოდი
Example	მაგალითი
Evening	საღამო
Exclude	გამორიცხავს
Explain	ახსნას
Explore	გამოკვლევა
Educate	განათლება
Factory	ქარხანა
Failure	წარუმატებლობა
Feature	თვისება
Finance	ფინანსები
Flavour	არომატი
Fluency	თავისუფლად ფლობა
Forever	სამუდამოდ
Further	უფრო
Garment	სამოსი
General	გენერალი
Genuine	ნამდვილი
Glamour	გლამურული
Grammar	გრამატიკა
Grocery	სასურსათო
Habitat	ჰაბიტატი
Harmful	მავნე
Harvest	მოსავალი
Heading	სათაური
Hearing	მოსმენა
Helpful	გამოსადეგი
History	ისტორია
Holding	ჩატარების
Holiday	დღესასწაული
Hundred	ასი
Husband	ქმარი
Hygiene	ჰიგიენა
Impress	შთაბეჭდილება მოახდინა
Improve	გაუმჯობესება
Include	მოიცავს
Initial	საწყისი
Inspect	შეამოწმოს
Inspire	შთააგონებს
Journey	მოგზაურობა
Justice	სამართლიანობა
Leading	წამყვანი
Leather	ტყავი
Leaving	ტოვებს
Lecture	ლექცია
Liberal	ლიბერალური
Lovable	საყვარელი
Luggage	ბარგი
Manager	მენეჯერი
Maximum	მაქსიმუმ
Meaning	მნიშვნელობა
Measure	საზომი
Medical	სამედიცინო
Message	შეტყობინება
Migrant	მიგრანტი
Mineral	მინერალური
Minimum	მინიმალური
Miracle	სასწაული
Missile	რაკეტა
Missing	დაკარგული
Mistake	შეცდომა
Morning	დილით
Mustard	მდოგვი
Mystery	საიდუმლო
Narrate	მოთხრობა
Natural	ბუნებრივი
Naughty	ცელქი
Neglect	უგულებელყოფა
Neither	არც ერთი
Nervous	ნერვული
Network	ქსელი
Nothing	არაფერი
Observe	დააკვირდი
Opening	გახსნა
Operate	იმოქმედოს
Opinion	აზრი
Organic	ორგანული
Ostrich	სირაქლემას
Package	პაკეტი
Painful	მტკივნეული
Partial	ნაწილობრივი
Passage	გადასასვლელი
Patient	პაციენტი
Payment	გადახდა
Penalty	ჯარიმა
Pending	მომლოდინე
Penguin	პინგვინი
Pension	პენსია
Perfect	სრულყოფილი
Perfume	სუნამო
Popular	პოპულარული
Pottery	ჭურჭელი
Poverty	სიღარიბე
Prevent	თავიდან აცილება
Privacy	კონფიდენციალურობა
Private	კერძო
Problem	პრობლემა
Produce	აწარმოოს
Propose	შესთავაზეს
Purpose	დანიშნულება
Quality	ხარისხიანი
Quickly	სწრაფად
Receive	მიღება
Regular	რეგულარული
Related	დაკავშირებული
Release	გათავისუფლება
Replace	ჩანაცვლება
Reptile	ქვეწარმავალი
Request	მოთხოვნა
Respect	პატივისცემა
Respond	რეაგირება
Revenge	შურისძიება
Revenue	შემოსავალი
Reverse	საპირისპირო
Robbery	ძარცვა
Romance	რომანტიკა
Science	მეცნიერება
Serious	სერიოზული
Servant	მსახური
Service	სერვისი
Similar	მსგავსი
Society	საზოგადოება
Sparrow	ბეღურა
Special	განსაკუთრებული
Stomach	კუჭის
Student	სტუდენტი
Success	წარმატება
Suggest	ვარაუდობენ
Suicide	თვითმკვლელობა
Support	მხარდაჭერა
Suspend	შეაჩეროს
Teacher	მასწავლებელი
Teenage	თინეიჯერი
Tension	დაძაბულობა
Tourism	ტურიზმი
Trouble	უბედურება
Uniform	ერთიანი
Utility	სასარგებლო
Vacancy	ვაკანსია
Variety	მრავალფეროვნება
Vehicle	მანქანა
Village	სოფელი
Vintage	ვინტაჟი
Victory	გამარჯვება
Violent	ძალადობრივი
Visible	ხილული
Visitor	სტუმარი
Vitamin	ვიტამინი
Walking	სიარული
Wanting	მსურველი
Warning	გაფრთხილება
Wealthy	მდიდარი
Weather	ამინდი
Wedding	ქორწილი
Welcome	მოგესალმებით
Welfare	კეთილდღეობა
Winning	გამარჯვების
Working	სამუშაო
Worried	შეშფოთებული
Worship	თაყვანისცემა
Writing	წერა
Abnormal	არანორმალური
Absolute	აბსოლუტური
Accepted	მიღებული
Accident	უბედური შემთხვევა
Accuracy	სიზუსტე
Activate	გააქტიურება
Addition	დამატება
Adequate	ადეკვატური
Affected	დაზარალებული
Alphabet	ანბანი
Anything	არაფერი
Anywhere	სადმე
Appraise	შეფასება
Approach	მიდგომა
Approval	დამტკიცება
Argument	არგუმენტი
Assemble	შეკრება
Attitude	დამოკიდებულება
Audience	აუდიტორია
Attorney	ადვოკატი
Aviation	ავიაცია
Backward	ჩამორჩენილი
Beginner	დამწყები
Birthday	დაბადების დღე
Bleeding	სისხლდენა
Building	შენობა
Campaign	კამპანია
Carriage	ვაგონი
Children	ბავშვები
Cleavage	დეკოლტე
Complete	სრული
Conserve	კონსერვაცია
Consider	განიხილოს
Consumer	მომხმარებელი
Continue	გააგრძელე
Criminal	დამნაშავე
Critical	კრიტიკული
Daughter	ქალიშვილი
Decision	გადაწყვეტილება
Decrease	შემცირება
Delicate	დელიკატური
Delivery	მიწოდება
Delusion	ბოდვა
Describe	აღწერე
Disagree	უარყოფა
Disallow	აკრძალვა
Duration	ხანგრძლივობა
Economic	ეკონომიკური
Elephant	სპილო
Eligible	უფლებამოსილი
Employee	თანამშრომელი
Enormous	უზარმაზარი
Entrance	შესასვლელი
Envelope	კონვერტი
Estimate	შეფასება
Everyday	ყოველ დღე
Exercise	ვარჯიში
Explicit	გამოკვეთილი
Exposure	კონტაქტი დაინფიცირების წყაროსთან
External	გარე
Facility	დაწესებულება
Faithful	ერთგული
Favorite	საყვარელი
Festival	ფესტივალი
Flexible	მოქნილი
Friction	ხახუნის
Generate	გენერირება
Greeting	მისალმება
Guardian	მეურვე
Heritage	მემკვიდრეობა
Horrible	საზარელი
Hospital	საავადმყოფო
Humorous	იუმორისტული
Identity	ვინაობა
Incident	ინციდენტი
Increase	მომატება
Indicate	მიუთითეთ
Industry	ინდუსტრია
Jealousy	ეჭვიანობა
Learning	სწავლა
Location	მდებარეობა
Majority	უმრავლესობა
Marriage	ქორწინება
Material	მასალა
Medicine	წამალი
Moderate	ზომიერი
Mosquito	კოღო
Mountain	მთა
Narrator	მთხრობელი
Nutrient	მკვებავი
Opposite	საწინააღმდეგო
Original	ორიგინალური
Ornament	ორნამენტი
Painting	ფერწერა
Particle	ნაწილაკი
Patience	მოთმინება
Pleasure	სიამოვნება
Position	პოზიცია
Positive	დადებითი
Possible	შესაძლებელია
Postpone	გადადება
Powerful	ძლიერი
Precious	ძვირფასი
Pregnant	ორსული
Pressure	წნევა
Previous	წინა
Progress	პროგრესი
Prohibit	აკრძალოს
Property	ქონება
Purchase	შესყიდვა
Quantity	რაოდენობა
Recovery	აღდგენა
Regional	რეგიონალური
Relevant	შესაბამისი
Religion	რელიგია
Remember	გახსოვდეს
Research	კვლევა
Resource	რესურსი
Response	პასუხი
Restrict	შეზღუდოს
Revision	გადახედვა
Sensible	გონივრული
Sentence	სასჯელი
Separate	ცალკე
Stranger	უცნობი
Strategy	სტრატეგია
Strength	ძალა
Struggle	ბრძოლა
Suitable	შესაფერისი
Superior	უმაღლესი
Surprise	გაოცება
Swelling	შეშუპება
Terrible	საშინელი
Together	ერთად
Tomorrow	ხვალ
Training	ტრენინგი
Transfer	გადაცემა
Transmit	გადასცემს
Treasure	საგანძური
Umbrella	ქოლგა
Universe	სამყარო
Vacation	შვებულება
Validate	დადასტურება
Vertical	ვერტიკალური
Vigorous	ენერგიული
Violence	ძალადობა
Vocation	მოწოდება
Vomiting	ღებინება
Wildlife	ველური ბუნება
Yielding	მომცემი
Yourself	საკუთარ თავს
Youthful	ახალგაზრდული
Accession	შეერთება
Accessory	აქსესუარი
Accompany	ერთად
Actualize	აქტუალიზება
Admirable	აღფრთოვანებული
Advantage	უპირატესობა
Advisable	მიზანშეწონილი
Affection	მოსიყვარულეობა
Affiliate	შვილობილი
Afternoon	შუადღე
Aggregate	აგრეგატი
Agreement	შეთანხმება
Allowance	შემწეობა
Alternate	ალტერნატიული
Ambiguous	ორაზროვანი
Animation	ანიმაცია
Apologist	აპოლოგეტი
Applicant	განმცხადებელი
Architect	არქიტექტორი
Associate	ასოცირებული
Astronomy	ასტრონომია
Attention	ყურადღება
Attribute	ატრიბუტი
Authority	ავტორიტეტი
Automatic	ავტომატური
Available	ხელმისაწვდომი
Awareness	ცნობიერება
Beautiful	ლამაზი
Behaviour	მოქმედება
Butterfly	პეპელა
Calibrate	დაკალიბრება
Candidate	კანდიდატი
Celebrate	აღსანიშნავად
Challenge	გამოწვევა
Confident	თავდაჯერებული
Confusion	დაბნეულობა
Conscious	შეგნებული
Crocodile	ნიანგი
Curiosity	ცნობისმოყვარეობა
Dangerous	საშიში
Delicious	გემრიელი
Democracy	დემოკრატია
Dependent	დამოკიდებული
Different	განსხვავებული
Difficult	რთული
Discovery	აღმოჩენა
Dishonest	უპატიოსნო
Diversity	მრავალფეროვნება
Duplicate	დუბლიკატი
Education	განათლება
Effective	ეფექტური
Emergency	სასწრაფო
Equipment	აღჭურვილობა
Essential	არსებითი
Establish	დაამყარონ
Evolution	ევოლუცია
Excellent	შესანიშნავი
Expensive	ძვირი
Fantastic	ზღაპრული
Fertility	ნაყოფიერება
Financial	ფინანსური
Generally	ზოგადად
Glamorous	გლამურული
Happening	ხდება
Household	საყოფაცხოვრებო
Identical	იდენტური
Important	მნიშვნელოვანი
Incorrect	არასწორი
Incorrupt	უხრწნელი
Influence	გავლენა
Insurance	დაზღვევა
Interview	ინტერვიუ
Intestine	ნაწლავი
Introduce	გააცნო
Invention	გამოგონება
Invisible	უხილავი
Irregular	არარეგულარული
Jewellery	სამკაულები
Knowledge	ცოდნა
Liability	პასუხისმგებლობა
Misbehave	არასწორად მოქცევა
Narration	თხრობა
Necessity	აუცილებლობა
Negotiate	მოლაპარაკება
Nutrition	კვება
Offensive	შეურაცხმყოფელი
Partition	დანაყოფი
Political	პოლიტიკური
Pollution	დაბინძურება
Potential	პოტენციალი
Practical	პრაქტიკული
Precision	სიზუსტე
Privilege	პრივილეგია
Procedure	პროცედურა
Prominent	გამოჩენილი
Professor	პროფესორი
Promotion	დაწინაურება
Provoking	პროვოცირებას
Qualified	კვალიფიციური
Reference	მითითება
Repulsion	მოგერიება
Residence	რეზიდენცია
Sacrifice	მსხვერპლი
Sensitive	მგრძნობიარე
Something	რაღაც
Statement	განცხადება
Subscribe	გამოწერა
Substance	ნივთიერება
Sugarcane	შაქრის ლერწამი
Sunflower	მზესუმზირა
Surrender	დანებება
Technical	ტექნიკური
Temporary	დროებითი
Terrorist	ტერორისტი
Treatment	მკურნალობა
Variation	ვარიაცია
Vegetable	ბოსტნეულის
Virginity	ქალწულობა
Yesterday	გუშინ
Abbreviate	შემოკლება
Absolutely	აბსოლუტურად
Absorption	შთანთქმის
Acceptable	მისაღები
Achievable	მიღწევადი
Additional	დამატებითი
Admiration	აღტაცება
Adolescent	მოზარდი
Adulterant	გარყვნილი
Adventurer	ავანტიურისტი
Afterwards	შემდეგ
Aggression	აგრესია
Alteration	შეცვლა
Ambassador	ელჩი
Analytical	ანალიტიკური
Antibiotic	ანტიბიოტიკი
Anticipate	განჭვრეტა
Appreciate	ვაფასებ
Artificial	ხელოვნური
Aspiration	სწრაფვა
Assignment	დავალება
Atmosphere	ატმოსფერო
Attachment	დანართი
Attraction	მიზიდულობა
Chloroform	ქლოროფორმი
Combustion	წვის
Commission	კომისია
Compassion	თანაგრძნობა
Compulsory	სავალდებულო
Conclusion	დასკვნა
Confection	საკონდიტრო ნაწარმი
Corruption	კორუფცია
Decoration	გაფორმება
Dedication	თავდადება
Deficiency	დეფიციტი
Definition	განმარტება
Department	დეპარტამენტი
Depression	დეპრესია
Dictionary	ლექსიკონი
Discipline	დისციპლინა
Disclaimer	პასუხისმგებლობის უარყოფა
Disclosure	გამჟღავნება
Discussion	დისკუსია
Efficiency	ეფექტურობა
Employment	დასაქმება
Engagement	ჩართულობა
Everything	ყველაფერი
Everywhere	ყველგან
Exhibition	გამოფენა
Experience	გამოცდილება
Experiment	ექსპერიმენტი
Expiration	ვადის გასვლა
Expression	გამოხატულება
Fertilizer	სასუქი
Foundation	ფონდი
Generation	თაობა
Government	მთავრობა
Importance	მნიშვნელობა
Impossible	შეუძლებელია
Inadequate	არაადეკვატური
Incomplete	არასრული
Incredible	წარმოუდგენელი
Individual	ინდივიდუალური
Inspection	შემოწმება
Instrument	ინსტრუმენტი
Irrigation	სარწყავი
Journalism	ჟურნალისტიკა
Management	მენეჯმენტი
Moderation	ზომიერება
Motivation	მოტივაცია
Negligible	უმნიშვნელო
Occupation	ოკუპაცია
Particular	კონკრეტული
Passionate	ვნებიანი
Permission	ნებართვა
Population	მოსახლეობა
Production	წარმოება
Protection	დაცვა
Psychology	ფსიქოლოგია
Punishment	სასჯელი
Quarantine	კარანტინი
Retirement	საპენსიო
Sufficient	საკმარისი
Supervisor	ზედამხედველი
Supplement	დანამატი
University	უნივერსიტეტი
Vegetarian	ვეგეტარიანელი
Visibility	ხილვადობა
Vulnerable	დაუცველი
Accommodate	დაბინავება
Achievement	მიღწევა
Acknowledge	აღიარებს
Affirmation	დადასტურება
Aggregation	აგრეგაცია
Agriculture	სოფლის მეურნეობა
Alternation	მონაცვლეობა
Anniversary	საიუბილეო
Application	განაცხადი
Appointment	დანიშვნა
Appreciable	შესაფასებელი
Approximate	მიახლოებითი
Association	ასოციაცია
Certificate	სერტიფიკატი
Competition	კონკურსი
Cultivation	გაშენება
Corporation	კორპორაცია
Cooperation	თანამშრომლობა
Dehydration	გაუწყლოება
Discontinue	შეწყვიტოს
Elimination	აღმოფხვრა
Environment	გარემო
Evaporation	აორთქლება
Examination	ექსპერტიზა
Expenditure	ხარჯი
Fabrication	ფაბრიკაცია
Improvement	გაუმჯობესება
Independent	დამოუკიდებელი
Information	ინფორმაცია
Inspiration	შთაგონების
Institution	დაწესებულება
Instruction	ინსტრუქცია
Intelligent	ინტელექტუალური
Manufacture	წარმოება
Measurement	გაზომვა
Mensuration	მენსურაცია
Observation	დაკვირვება
Opportunity	შესაძლებლობა
Participant	მონაწილე
Performance	შესრულება
Preparation	მომზადება
Significant	მნიშვნელოვანი
Temperature	ტემპერატურა
Translation	თარგმანი
Transparent	გამჭვირვალე
Vaccination	ვაქცინაცია
Abbreviation	აბრევიატურა
Administrate	ადმინისტრირება
Appreciation	დაფასება
Accommodation	განთავსება
Accompaniment	თანხლებით
Administrator	ადმინისტრატორი
Advertisement	რეკლამა
Administration	ადმინისტრაცია
Acknowledgement	აღიარება
Conformation	კონფორმაცია
Conservation	კონსერვაცია
Constitution	კონსტიტუცია
Construction	მშენებლობა
Contribution	წვლილი
Communication	კომუნიკაცია
Classification	კლასიფიკაცია
Congratulation	მილოცვა
Disadvantage	მინუსი
Entrepreneur	მეწარმე
Entertainment	გასართობი
Extraordinary	არაჩვეულებრივი
Horticulture	მებაღეობა
Intermediate	შუალედური
Introduction	შესავალი
Investigation	გამოძიება
International	საერთაშორისო
Identification	იდენტიფიკაცია
Justification	გამართლება
Knowledgeable	მცოდნე
Maintainable	შესანარჩუნებელი
Organization	ორგანიზაცია
Presentation	პრეზენტაცია
Preservation	კონსერვაცია
Purification	განწმენდა
Participation	მონაწილეობა
Registration	რეგისტრაცია
Reproduction	რეპროდუქცია
Satisfaction	კმაყოფილება
Self-confidence	თავდაჯერებულობა
Transformation	ტრანსფორმაცია
Transportation	ტრანსპორტირება